1111111111111
10P00000000E1
1001101110001
1001100111001
1C00000000C01
1111111111111
