1111111111111
1P000000000E1
1000101100001
1111111111111
1000100011001
1C00100000001
1111111111111
