1111111111111
10P00000000E1
1000101100001
1000100011001
1C00100000C01
1111111111111
