1111111111111
10P000000e0E1
1001101110001
1001100111001
1C000000H0C01
1111111111111
