111111111111111111111111111111111111111111111111111
100000C0000000C000000000000000000000000000000000001
111110010000000000000000000000000000000001111100001
1E0000000000000000000000C00000000000000010000000001
100000000000000000000000000000000000000000000000001
10000000000000000000000000000000000000C000000000001
100000000000000000000000000000000000000000000000001
10000C000000000000000000000000001111111000000000001
10000C000000000000000000000000000000001111000000001
100000000011111010101111110000000000000000000000001
100000000000000000000000000000000000111010000101001
100000000000000000000000000000000001111111111111111
10000C000000000000000000000000000111100000101011111
10000000000000C000000000000000001000000000000000001
100000000000000000000000000000110010000110000010001
1C0000000000000000000000000000000000000000000000001
10000000000000000000000000000000000000C000000000001
10000C010000000000000000000000000000000001000000001
1000000000C0000000000000000000010000000000000000001
100000000000000000000000000000000000000000000000001
111111111111111111111111111111111111111111111111111
